#####-----> Country Tags <><> <><> <><> <><> <><>

AHV = "countries/Aland.txt"
BAV = "countries/Bavaria.txt"
BRI = "countries/Brittany.txt"
CAT = "countries/Catalonia.txt"
COR = "countries/Corsica.txt"
DNZ = "countries/Danzig.txt"
DON = "countries/Don Cossack Host.txt"
DOU = "countries/Directorate of Ukraine.txt"
EFR = "countries/Etat_Francais.txt"
EUS = "countries/Euskal Herria.txt"
FAK = "countries/Fake.txt"
FRI = "countries/French Indochina.txt"
G01 = "countries/G01.txt"
GRL = "countries/Greenland.txt"
GBR = "countries/Guyana.txt"
KUR	= "countries/Kurdistan.txt"
MCD = "countries/Macedonia.txt"
NIG = "countries/Nigeria.txt"
PGR = "countries/PGR.txt"
QBC = "countries/Quebec.txt"
RGR = "countries/RGR.txt"
RUT = "countries/Ruthenia.txt"
SCA = "countries/Scandinavia.txt"
VLA = "countries/Vlaanderen.txt"
WAF = "countries/Cingdom of Cat.txt"
WHY = "countries/Tender Loving Empire.txt"
WLL = "countries/Wallonia.txt"
LOI = "countries/Lordship of the Isles.txt"
NKR = "countries/North Korea.txt"
GLC = "countries/Galicia.txt"
CRI = "countries/Crimea.txt"

TNG = "countries/Tunganistan.txt"

#####-----> End <><> <><> <><> <><> <><>